00000000000000000000000000
00000000000000000000000000
00110011001100110011001100
00110011001100110011001100
00110011001100110011001100
00110011001100110011001133
00110011441122115511001133
00110011441122115511001133
00110011001100110011001133
00110011000000000011001133
00110011000000000011001100
00000000001100110000000000
00000000001100110000000000
00001111000000000011110000
22001111000000000011110022
00000000001100110000000000
00000000001111110000000000
00000011001111110011000000
00110011001100110011001100
00110011001100110011001100
00110011001100110011001100
00110011000000000011001100
00110011000000000011001100
00110011000111100011001100
00000000000100100000000000
00000000000100100000000000
