00000000000000000000000000000000000000000000000000
00000000000000000000000000000000000000000000000000
00000000000000000000000000000000000000000000000000
00000000000000000000000000000000000000000000000000
00000000000000000000000000000000000000000000000000
00000000000000000000000000000000000000000000000000
00000000000000000000000000000000000000000000000000
00000000000000000000000000000000000000000000000000
33111111111111111111111111111111111111111111111133
33111111111111111111111111111111111111111111111133
00000000000000000000000000000000000000000000000000
00000000000000000000000000000000000000000000000000
00000000000000000000000000000000000000000000000000
00000000000000000033333333333333333000000000000000
00000000000000000033333333333333333000011111111100
00000000000000000033333333333333333000011111111100
55555555555555500033333333333333333000011111111100
55555555555555500033333333333333333000011000001100
00000000000000000033333333333333333000011000001100
00000000000000000033333333333333333000011000001100
00000000000000000000000000000000000000011000001100
00000000000000000000000000000000000000011000001100
00000000000000000000000000000000000000011000001100
00000000000000000000000000000000000000011000001100
00000000000222222222222222222222222200011000001100
00000000000000000000000000000000000000011000001100
00000000000000000000000000000000000000011000001100
04444444444000000000000000000000000000011000001100
04444444444000000000000000000000000000011000001100
04444444444000000000000000000000000000011111111100
04444444444000000000000000000000000000011111111100
04444444444000000000000000000000000000011111111100
00000000000000000000000000000000000000000000000000
00000000000000000002222222200000000000000000000000
00000000000000000002000000200000000000000000000000
00000000000000000002000000200000000000000000000000
00000000000000000002011110000000000000000000000000
00000000000000000002010010000000000000000000000000
00000000000000000002010010200000000000000000000000
00000000000000000002010010200000000000000000000000
