00000000000000000000000000000000000000000000000000
00000000000000000000000000000000000000000000000000
00000000000000011111100000000000000000000000000000
00000000000000011111100000000000000000000000000000
00000000000000011111100000000000000000000000000000
0000000000000000000000000000000000000000000000000
00000333333330000000000000000000000022222222000000
00000333333330000005555555555555000022222222000000
00000000000000000000000000000000000000000000000000
00000000000000000000000000000000000000000000000000
00000000000000000000000000000000000000000000000000
00000000000000000333333333333333333000000000000000
00000000000000000333333333333333333000000000000000
00000000000000000000000000000000000000000000000000
00000000000000000000000000000000000000000000000000
00000000000011111111100000000000000000000000000000
00000000000011111111100044440000000000444444444000
00000000000011111111100044440000000000000000000000
00000000000000000000000000000000000000444444444400
00000000000000000000000000000000000000444444444400
00000000000000000000000000000000000000000000000000
00000000000000000000000000000000000000000000000000
00033333333333333333333333333333333333000000000000
00033333333333333333333333333333333333000000000000
00000000000000000000000000000000000000000000000000
00000000000000000000000000000000000000000000000000
00000000000000555555555555555500000000000000000000
00000000000000000000000000000000000000000000000000
00000000000000000000000000000000000000000000000000
00000000000000000000000000000333333333333333300000
00000444444444444444400000000333333333333333300000
00000444444444444444400000000000000000000000000000
00000000000000000000000000000000000000000000000000
00000000000000000000000000000000000000000000000000
00000000000000000000000000000000000000000000000000
00000000000000000000000000000000000000000000000000
00000000000000000000000000000000000000000000000000
00000000000000000000000000000000000000000000000000
00000000000000000000000000000000000000000000000000
00000000000000000000000000000000000000000000000000
