44440000000000000000000000000000000000000000004444
40000000000000000000000000000000000000000000000004
40000000000000000000000000000000000000000000000004
40000000000000000000000000000000000000000000000004
40000000000000000000000000000000000000000000000004
00000000000000000000000000000000000000000000000000
00000000000000000000000000000000000000000000000000
00000000000000000000000000000000000000000000000000
33111111111111111111111111111111111111111111111133
33111111111111111111111111111111111111111111111133
00000000000000000000000000000000000000000000000000
00000000000000000000000000000000000000000000000000
00000000000000000000000000000000000000000000000000
00000000000000000000000000000000000000000000000000
00000000000000000000000000000000000000000000000000
00000000000000000000000000000000000000555555555555
55555555555555500000000000000000000000555555555555
55555555555555500000000000000000000000000000000000
00000000000000000000000000000000000000000000000000
00000000000000000000000000000000000000000000000000
00000000000000000000000000000000000000000000000000
00000000000000000000000000000000000000000000000000
00000000000000000000000000000000000000000000000000
00000000000000000000000000000000000000000000000000
00000000000222222222222222222222222200000000000000
00000000000000000000000000000000000000000000000000
00000000000000000000000000000000000000000000000000
00000000000000000000000000000000000000000000000000
00000000000000000000000000000000000000000000000000
00000000000000000000000000000000000000000000000000
00000000000000000000000000000000000000000000000000
00000000000000000000000000000000000000000000000000
00000000000000000000000000000000000000000000000000
00000000000000000000000000000000000000000000000000
00000000000000000001111111000000000000000000000004
40000000000000000001000001000000000000000000000004
40000000000000000001000001000000000000000000000004
40000000000000000001000001000000000000000000000004
40000000000000000001000001000000000000000000000004
44444444444444444441000001444444444444444444444444
